                                 +--------+
                                 |........|
                                 |........|
                                 |........|
                      +-+        |........|
+--------+            |.|        +--+.+---+
|........|            |.|           |.|    
|........+------------+.+-----------+.+---+  +---+
|.........................................|  |...|
|........+------+.+---------------------+.+--+...|
|........|      |.|                     |........| 
|........|      |.|                     |.+--+---+
+---+.+--+    +-+.+----+                |.|
    |.|       |........|   +--------+   |.|
    |.+------+|........|   |........+---+.|
    |........||........+---+..............|
    +---+.+--+|.....................+-----+      
        |.|   |........+---+........|      
        +-+   +--------+   |........|      
                           |........|      
                           |........|      
                           |........|      
                           |........|      
                           +--------+      