                                 +--------+
                                 |........|
                                 |........|
                                 |........|
                      +-+        |........|
+--------+            |.|        +--+.+---+
|........|            |.|           |.|    
|........+------------+.+-----------+.+---+  +---+
|.........................................|  |...|
|........+------+.+---------------------+.+--+...|
|........|      |.|                     |........| 
|........|      |.|        +--------+   |.+--+---+
+---+.+--+    +-+.+----+   |........|   |.|
    |.|       |........|   |........|   |.|
    |.+------+|........|   |........+---+.|
    |........||........+---+..............|
    +---+.+--+|.....................+-----+      
        |.|   |........+---+........|      
        +-+   |........|   |........|      
              +--------+   |........|      
                           |........|
                           +--------+      