                                 +--------+
                                 |........|
                                 |........|
                                 |........|
                                 |........|
+--------+             *         +---.----+
|........|             |             |     
|........|             |             |      +---+
|.........-------+-----+-------------+---+  |...|
|........|       |                       |  |...|
|........|       |                       +--....| 
|........|       |                       |  +---+
+----.---+    +--.-----+                 | 
     |        |........|   +--------+    | 
     |        |........|   |........|    | 
     +---+--* |........|   |.........----+ 
         |    |.........---.........|      
         *    |........|   |........|      
              +--------+   |........|      
                           |........|      
                           |........|      
                           |........|      
                           |........|      
                           +--------+      