    +-------------+                                                           
    |.............| +--------------------+            +-------+               
    |.............| |....................| +-------+  |.......|               
    |.............| |....................| |.......|  |.......|               
    |.............| +------------------+.+ |.......+--+.......|               
    |.............|                    |.| |..................|               
    |.............+--------------+     |.| |.......+--+.......|  +-----------+
    |............................|     |.| +-------+  |.......|  |...........|
    +--+.+-----------+...........|     |.|            |.......+--+...........|
       |.|           |...........|     |.|    +-----+ |......................|
+------+.+-------+   +-----------+  +--+.+--+ |.....| |.......+--+...........|
|................|                  |.......| |.....+-+.......|  |...........|
|................+------------------+.......| |...............|  |...........|
|...........................................| |.....+-+.......|  |...........|
|................+------------------+.......| +-----+ |.......|  |...........|
|................|  +-------+       |.......|         |.......|  +-----------+
|................|  |.......|       +-------+         |.......|               
+--------+.+-----+  |.......|                         |.......|               
         |.|        +--+.+--+ +----------------+      |.......|               
         |.+-----------+.+----+................+------+.......|               
         |....................................................|               
         +--------------------+................+--------------+               
                              +----------------+                              