     +----------+ +--------+                  
     |..........| |........|                  
     |..........| |........+-----------+      
     ++.+-------+ |....................|      
      |.|         +------------+.+-----+      
+---+ |.|  +------+            |.|  +--------+
|...| |.|  |......| +----------+.++ |........|
|...| |.|  |......+-+.............| |........|
|...| |.|  |......................| |........|
|...| |.+--+......+---------------+ |........|
|...| |...........|                 |........|
|...| |.+--+......+---------------+ |........|
|...+-+.|  |......................+-+........|
|.......|  |.................................|
+-------+  +---------------------------------+